Name,Volume,Ask Size,Ask Price,Bid Size,Bid Price,Last Price,Shares Matched,Shares Routed
UVIX,10768786,100,3.40,500,3.35,3.39,10760338,8448
MSTU,8616791,800,8.01,800,7.98,7.99,8498158,118633
TSLZ,3888031,12343,2.37,11490,2.36,2.37,3833103,54928
MSTZ,2432264,400,27.03,400,26.99,27.05,2409623,22641
UVXY,2395361,300,20.77,113,20.25,20.64,2360246,35115
NVDQ,2074918,7800,3.20,16148,3.19,3.20,2073167,1751
NVDX,1606168,1028,14.61,1028,14.57,14.61,1582186,23982
ETHU,1352573,9600,7.83,12000,7.80,7.83,1296442,56131
BITX,1281192,2200,50.99,1200,50.84,51.05,1262545,18647
IEFA,1174671,0,0.00,2,69.58,70.31,1174365,306
FBTC,1077106,1900,80.83,2400,80.68,80.61,1074304,2802
VXX,813826,60,45.80,1,44.98,45.70,809210,4616
ITB,731534,8,104.00,1,101.95,103.31,728659,2875
SVIX,574343,100,25.55,485,25.40,25.55,572406,1937
IGV,555077,1,101.73,1381,100.59,100.71,549202,5875
USHY,532633,10,37.20,21,36.72,36.78,531433,1200
GOVT,350118,0,0.00,2,22.45,22.52,349697,421
ARKG,343992,3,24.42,1,23.50,23.60,342728,1264
INDA,325485,100,52.77,100,52.61,52.70,315794,9691
CBOE,270353,100,195.93,0,0.00,196.01,270353,0
TSLT,256608,200,40.02,36,39.93,40.00,246721,9887
BBJP,241428,0,0.00,14,54.05,54.92,236637,4791
TLTW,234263,3,23.60,20,23.38,23.40,233035,1228
USMV,233848,0,0.00,17,88.00,88.72,230884,2964
ARKB,229686,2000,92.38,220,92.30,92.39,228977,709
FLOT,222444,900,50.91,501,50.85,50.87,199856,22588
CALF,198864,0,0.00,0,0.00,43.84,197080,1784
IAGG,174306,666,49.97,0,0.00,47.47,174305,1
SVXY,169884,10,50.31,10,50.00,50.09,169383,501
VIXY,168080,30,45.00,200,44.00,44.81,167289,791
FETH,154006,5000,33.62,5000,33.38,33.96,153799,207
QDTE,152282,10,40.31,110,40.20,40.32,151506,776
NOBL,151020,240,103.45,15,98.73,99.20,150689,331
COWZ,140807,0,0.00,15,55.82,56.16,136514,4293
EFV,140229,0,0.00,0,0.00,52.39,138289,1940
PAVE,137093,0,0.00,1,40.00,40.42,135152,1941
QUAL,134234,0,0.00,40,177.50,178.58,133926,308
EZU,120948,0,0.00,0,0.00,47.14,120594,354
AAAU,120254,10100,25.79,50,25.70,25.92,118484,1770
BBEU,117352,0,0.00,0,0.00,55.45,117352,0
HYD,112995,295,52.22,1,51.68,51.80,112508,487
SPYI,111938,10,51.24,2,50.95,51.01,111320,618
MTUM,105095,0,0.00,2,204.67,207.89,103326,1769
MOAT,102140,32,95.12,10,92.00,92.50,101724,416
IQDG,94847,0,0.00,0,0.00,34.34,94847,0
IDV,91227,0,0.00,0,0.00,27.32,82525,8702
GOVZ,82358,0,0.00,1000,9.90,9.98,82358,0
BUFR,78214,0,0.00,0,0.00,30.52,51514,26700
BTCZ,74090,900,6.06,1320,6.04,6.02,72509,1581
ITA,73514,181,153.38,2,145.50,145.52,73211,303
ECH,67376,0,0.00,0,0.00,25.04,62168,5208
BBAX,66335,0,0.00,0,0.00,48.93,65516,819
JCPB,64145,0,0.00,0,0.00,46.30,54345,9800
FBCG,64060,0,0.00,100,46.30,46.35,64060,0
DFIC,61610,0,0.00,0,0.00,25.81,61210,400
BOXX,55399,40,110.24,405,110.20,110.21,55371,28
HEFA,55139,0,0.00,0,0.00,34.64,55139,0
JMUB,54078,0,0.00,0,0.00,50.30,54078,0
REM,53723,0,0.00,10,20.95,21.00,53722,1
VNM,51464,0,0.00,50,11.53,11.54,50146,1318
DFIS,51450,0,0.00,0,0.00,24.52,51319,131
ESGV,50809,4,107.21,18,91.42,105.36,46400,4409
JMST,50378,0,0.00,0,0.00,50.82,50378,0
BBCA,49977,0,0.00,5,70.00,70.33,49758,219
JBBB,47870,0,0.00,50,48.75,49.16,47463,407
NEAR,47719,100,50.64,100,50.20,50.46,47719,0
VLUE,46792,0,0.00,0,0.00,105.29,45936,856
IYT,46682,200,68.79,1,67.20,67.64,45953,729
EZBC,46650,3600,53.82,3600,53.31,54.64,46262,388
GVI,46519,0,0.00,0,0.00,104.26,45528,991
EFG,45581,0,0.00,0,0.00,97.02,45581,0
IBHF,44074,0,0.00,0,0.00,23.15,44074,0
ITM,43653,0,0.00,0,0.00,46.16,42724,929
XDTE,42571,10,50.29,97,50.00,50.33,42564,7
BTCL,42247,130,48.23,130,47.51,49.80,42210,37
VIXM,42191,79,14.80,2,14.39,14.57,34529,7662
YBTC,41987,0,0.00,54,48.75,48.75,38249,3738
PICK,41031,0,0.00,41,34.75,34.86,40285,746
EFAV,40492,0,0.00,0,0.00,70.64,39620,872
DUSA,38948,0,0.00,0,0.00,42.09,38287,661
VUSB,38615,500,49.63,500,49.58,49.60,38615,0
ICVT,38446,0,0.00,6,84.46,85.10,38396,50
KNG,38426,0,0.00,3,50.00,50.08,37137,1289
WTAI,38408,0,0.00,1,21.99,22.16,37608,800
HYDB,38386,0,0.00,0,0.00,46.96,37568,818
GSEW,35776,0,0.00,0,0.00,77.17,35776,0
GSUS,35535,0,0.00,0,0.00,81.10,25830,9705
GDEC,35181,0,0.00,0,0.00,33.99,35181,0
BBHY,34101,0,0.00,0,0.00,46.38,34101,0
IYZ,34043,0,0.00,0,0.00,26.78,33918,125
HODL,31775,1800,105.04,1800,104.07,105.00,31775,0
LVHI,31129,0,0.00,0,0.00,30.33,26766,4363
OMFL,30806,0,0.00,15,54.14,54.45,30723,83
PJAN,30698,0,0.00,0,0.00,42.17,28595,2103
RDTE,29287,5,41.30,9,41.10,41.22,29286,1
PBUS,28946,0,0.00,0,0.00,59.13,28946,0
ACWV,28901,0,0.00,0,0.00,109.08,28827,74
RDVI,28714,0,0.00,0,0.00,24.16,28713,1
DISV,28289,0,0.00,0,0.00,26.55,28289,0
IBHE,27902,0,0.00,100,23.15,23.15,19702,8200
PDEC,27300,0,0.00,10,38.42,38.48,27300,0
MLN,26664,0,0.00,0,0.00,17.78,26564,100
PTLC,26561,0,0.00,0,0.00,53.67,26561,0
ARKQ,26520,33,85.00,25,78.06,78.55,26520,0
VTEC,26060,0,0.00,33,99.07,99.48,26060,0
IFRA,25269,1,48.98,0,0.00,46.18,24969,300
VSGX,24317,0,0.00,0,0.00,56.75,24005,312
MAMB,24067,0,0.00,0,0.00,22.20,24067,0
ICLO,23926,3130,25.67,100,25.54,25.64,23923,3
FLBL,23378,1000,24.37,55,24.24,24.25,22887,491
EEMV,23342,0,0.00,0,0.00,58.09,22441,901
IBMS,23210,0,0.00,0,0.00,25.36,22766,444
BTCO,23061,2000,92.73,2000,92.10,92.00,23061,0
DIHP,22632,0,0.00,0,0.00,25.22,22205,427
SMB,22501,0,0.00,0,0.00,17.08,22501,0
TMFC,22175,0,0.00,20,60.00,60.41,22174,1
BAMG,21015,0,0.00,0,0.00,34.43,9215,11800
MSSS,20756,0,0.00,0,0.00,27.56,20756,0
CNYA,20561,0,0.00,0,0.00,28.49,20361,200
ARKX,20402,114,21.00,5,19.57,19.69,20384,18
IYLD,20002,0,0.00,0,0.00,19.49,20002,0
BALT,19622,0,0.00,0,0.00,31.42,18122,1500
IWMI,19592,0,0.00,5,48.48,48.76,19592,0
IEO,19583,0,0.00,0,0.00,88.35,19582,1
ISPY,19461,0,0.00,30,43.24,44.50,18753,708
ICSH,19184,1000,50.43,3816,50.42,50.43,16336,2848
SMIN,19008,10,85.90,1,75.57,75.68,19008,0
XSHD,18834,0,0.00,7,14.30,14.42,18834,0
MPRO,18732,0,0.00,0,0.00,28.64,18732,0
IBMR,18619,0,0.00,0,0.00,24.98,18619,0
IBMN,18495,0,0.00,0,0.00,26.59,17595,900
SLVP,18375,0,0.00,3,11.11,11.44,17104,1271
JPIB,17900,0,0.00,0,0.00,47.56,17539,361
IBMO,17786,0,0.00,0,0.00,25.45,17786,0
IGEB,17546,0,0.00,0,0.00,44.43,17546,0
ICOW,17527,0,0.00,0,0.00,29.07,17321,206
NANC,17452,0,0.00,1,38.74,38.79,17452,0
HYMU,16874,1388,22.90,5,22.52,22.70,16874,0
IGRO,16666,0,0.00,0,0.00,67.76,16666,0
IBMP,16332,0,0.00,0,0.00,25.14,16332,0
JANJ,15802,0,0.00,0,0.00,25.02,15802,0
FRNW,15629,0,0.00,0,0.00,13.56,15629,0
BUFD,15400,0,0.00,0,0.00,25.55,15400,0
BTCW,15329,1800,98.54,1800,97.41,99.54,14764,565
JANQ,15257,0,0.00,0,0.00,24.93,13030,2227
FJUL,15106,0,0.00,0,0.00,49.04,15106,0
BTCI,15034,460,64.00,5,58.15,59.52,14906,128
DRSK,14826,0,0.00,0,0.00,27.49,14826,0
HYIN,14563,0,0.00,200,17.70,17.82,14063,500
FYLD,14549,0,0.00,0,0.00,25.16,7144,7405
RSBT,14470,0,0.00,0,0.00,16.71,14418,52
GCOW,13960,0,0.00,34,32.64,33.58,13960,0
SHYD,13727,0,0.00,0,0.00,22.57,9845,3882
NJAN,13694,0,0.00,0,0.00,48.07,13694,0
KNOV,13600,0,0.00,0,0.00,25.29,13600,0
IBHI,13547,0,0.00,0,0.00,23.45,13547,0
FLQM,13429,0,0.00,0,0.00,54.19,13429,0
DDEC,13215,0,0.00,0,0.00,40.22,7485,5730
BBUS,13175,0,0.00,3,106.00,106.36,12574,601
XMPT,12609,0,0.00,0,0.00,21.33,12309,300
SMMD,12455,0,0.00,0,0.00,67.91,12455,0
BUYW,12447,0,0.00,0,0.00,13.96,12447,0
CEFS,12218,0,0.00,100,21.00,21.44,12207,11
MDPL,11744,0,0.00,0,0.00,25.18,11744,0
LQDW,11350,97,26.45,0,0.00,26.34,9450,1900
WEED,11302,0,0.00,3,15.17,15.58,11302,0
OUSM,10698,0,0.00,0,0.00,43.60,10698,0
RBUF,10601,0,0.00,0,0.00,26.28,10601,0
SMAX,10413,0,0.00,0,0.00,25.25,10413,0
FDEC,10308,0,0.00,0,0.00,44.76,10308,0
XVV,10302,0,0.00,0,0.00,45.61,10302,0
IBHG,10167,0,0.00,0,0.00,22.20,10167,0
BALI,9977,5,30.55,5,30.35,30.39,9977,0
PSFF,9918,0,0.00,0,0.00,29.34,9918,0
IBHH,9855,0,0.00,0,0.00,23.41,9855,0
EMGF,9679,0,0.00,0,0.00,45.38,9119,560
ACIO,9598,0,0.00,0,0.00,40.30,9598,0
BUFQ,9580,0,0.00,0,0.00,31.58,9580,0
EZET,9416,7000,25.49,3500,25.43,25.83,9416,0
EYLD,9355,0,0.00,0,0.00,31.50,7755,1600
ICF,9340,0,0.00,100,59.01,59.67,9340,0
FCPI,9268,0,0.00,1,43.05,43.44,9175,93
GAA,9206,0,0.00,0,0.00,28.55,9206,0
SDVD,9201,0,0.00,0,0.00,21.42,9201,0
DDWM,9099,0,0.00,0,0.00,34.23,9099,0
SYLD,9057,0,0.00,7,67.87,68.05,9057,0
BBRE,9056,0,0.00,0,0.00,92.83,9056,0
GARP,9026,0,0.00,0,0.00,56.65,9026,0
ETU,8983,33,39.18,234,38.32,39.29,8983,0
PNOV,8914,0,0.00,0,0.00,37.91,8914,0
VCEB,8775,0,0.00,0,0.00,62.14,8775,0
FRDM,8771,0,0.00,0,0.00,32.86,8771,0
MBCC,8662,0,0.00,0,0.00,34.61,8662,0
IETC,8650,0,0.00,122,83.00,86.00,8650,0
GSST,8604,0,0.00,0,0.00,50.45,8604,0
XJH,8558,0,0.00,0,0.00,41.66,8513,45
KWT,8527,0,0.00,0,0.00,31.95,8527,0
TOKE,8436,0,0.00,7,4.95,5.08,7736,700
DWLD,8386,0,0.00,0,0.00,36.42,8386,0
ETQ,8316,500,9.77,386,9.62,9.93,8315,1
ESML,8282,0,0.00,0,0.00,41.99,8282,0
OVB,8244,0,0.00,0,0.00,20.30,8244,0
JANH,8191,0,0.00,0,0.00,25.03,8191,0
DIVB,8093,0,0.00,0,0.00,47.21,7940,153
CETH,7959,8400,16.78,5000,16.74,16.98,7927,32
GDE,7707,0,0.00,0,0.00,37.04,7707,0
NUDM,7551,0,0.00,0,0.00,30.14,6489,1062
FLHY,7506,0,0.00,0,0.00,23.86,7506,0
TMFG,7358,0,0.00,6,27.00,28.41,6769,589
MEAR,7283,0,0.00,0,0.00,49.99,7283,0
IGHG,7253,0,0.00,0,0.00,77.99,7190,63
CAOS,7217,139,88.14,200,87.10,87.36,7216,1
XDEC,7215,0,0.00,0,0.00,37.30,7215,0
PAUG,7185,0,0.00,0,0.00,38.54,7185,0
EMHY,7060,0,0.00,0,0.00,38.03,7060,0
UJAN,7020,0,0.00,0,0.00,38.93,7020,0
ZDEK,6986,0,0.00,0,0.00,23.95,4988,1998
JPLD,6776,0,0.00,0,0.00,51.70,6776,0
BUFZ,6718,0,0.00,0,0.00,23.97,6718,0
GOLY,6701,0,0.00,0,0.00,23.86,6701,0
CLSE,6618,0,0.00,0,0.00,23.07,6618,0
FLIA,6617,0,0.00,0,0.00,20.24,6617,0
SMDV,6613,0,0.00,0,0.00,67.58,6613,0
EPRF,6567,0,0.00,0,0.00,18.31,6567,0
DSCF,6425,0,0.00,0,0.00,22.34,6425,0
NULV,6337,0,0.00,0,0.00,39.27,5934,403
KJAN,6263,0,0.00,0,0.00,37.35,6263,0
PAPR,6237,0,0.00,0,0.00,36.73,6237,0
NUMV,6210,0,0.00,0,0.00,34.72,6210,0
FLDR,6194,0,0.00,0,0.00,49.93,6194,0
VFMO,6147,0,0.00,25,164.00,165.02,6147,0
FFLG,6117,0,0.00,0,0.00,25.34,5881,236
ITWO,6107,0,0.00,1,39.00,39.65,6107,0
FDEM,6092,0,0.00,0,0.00,25.36,6092,0
REGL,5952,0,0.00,0,0.00,80.48,5950,2
PRNT,5892,4,22.88,11,20.00,21.14,5838,54
XSHQ,5887,0,0.00,0,0.00,42.43,5887,0
AOCT,5881,0,0.00,0,0.00,24.96,5881,0
IBMQ,5863,0,0.00,0,0.00,25.17,5863,0
BUFS,5720,0,0.00,0,0.00,21.26,5720,0
KHPI,5701,0,0.00,0,0.00,25.43,5701,0
NUSC,5579,0,0.00,0,0.00,41.81,5579,0
TYA,5553,0,0.00,0,0.00,12.34,5553,0
FCLD,5522,0,0.00,1,26.88,27.73,3322,2200
GLOV,5508,0,0.00,1,49.30,49.46,5508,0
RSST,5489,0,0.00,0,0.00,23.80,5289,200
BGLD,5476,0,0.00,0,0.00,18.22,5476,0
ARKD,5465,0,0.00,0,0.00,47.91,5465,0
CEMB,5429,0,0.00,0,0.00,44.43,5429,0
DDLS,5419,0,0.00,0,0.00,34.64,5419,0
GTIP,5390,0,0.00,0,0.00,48.30,5390,0
SATO,5344,0,0.00,0,0.00,19.41,5344,0
IYJ,5303,0,0.00,0,0.00,133.56,5303,0
TMFM,5275,0,0.00,0,0.00,25.79,5074,201
FPFD,5189,0,0.00,0,0.00,22.50,4989,200
OVT,5176,0,0.00,0,0.00,21.99,5176,0
VTEI,5175,0,0.00,0,0.00,99.47,5175,0
UDEC,5140,0,0.00,0,0.00,35.23,4700,440
DINT,5120,0,0.00,0,0.00,21.89,5120,0
HEGD,5062,0,0.00,0,0.00,22.53,5062,0
OILK,5055,0,0.00,0,0.00,43.84,5055,0
RSSY,5013,0,0.00,0,0.00,20.40,3338,1675
MAXJ,4953,0,0.00,0,0.00,26.16,4753,200
ETHV,4907,0,0.00,2000,49.01,49.74,4907,0
QDEC,4813,0,0.00,0,0.00,27.68,3513,1300
FFLC,4807,0,0.00,686,45.77,46.09,4806,1
ZSEP,4712,0,0.00,0,0.00,25.08,4712,0
FDRV,4698,0,0.00,0,0.00,13.43,2185,2513
VCRM,4678,0,0.00,0,0.00,74.60,4678,0
HYGW,4676,0,0.00,100,31.40,31.78,4476,200
FFOG,4593,0,0.00,0,0.00,40.44,4593,0
IDUB,4552,0,0.00,0,0.00,20.10,4452,100
ZECP,4533,0,0.00,0,0.00,30.51,4386,147
DECU,4517,0,0.00,0,0.00,24.64,4517,0
PMAY,4500,0,0.00,0,0.00,35.96,4100,400
HYBL,4392,0,0.00,1,28.35,28.36,4392,0
VFQY,4296,0,0.00,0,0.00,140.86,4295,1
ZVOL,4267,0,0.00,1,18.60,18.94,4267,0
BBIN,4244,0,0.00,0,0.00,57.07,3130,1114
MSFX,4211,200,26.63,66,26.39,26.57,4211,0
BOXA,4200,0,0.00,0,0.00,99.80,4200,0
MARM,4195,0,0.00,0,0.00,30.90,4195,0
TSLP,4180,0,0.00,0,0.00,32.49,4178,2
IBHJ,4162,19,27.09,0,0.00,26.05,4162,0
FMAG,4160,0,0.00,0,0.00,31.11,3836,324
RSEE,4149,0,0.00,0,0.00,28.68,4149,0
VFVA,4147,0,0.00,0,0.00,117.75,4147,0
DFNL,4104,0,0.00,0,0.00,38.10,4104,0
RSSB,4083,0,0.00,0,0.00,23.41,3965,118
GOOX,4062,200,32.26,1,32.10,32.38,4062,0
SECT,4043,0,0.00,0,0.00,55.22,4043,0
FPAG,3936,0,0.00,0,0.00,30.39,3936,0
TMFE,3914,0,0.00,0,0.00,26.45,3914,0
DFEB,3902,0,0.00,0,0.00,42.82,3902,0
FMAY,3864,0,0.00,0,0.00,47.58,3864,0
AMZP,3822,0,0.00,1,31.90,34.05,3822,0
SMMV,3808,0,0.00,0,0.00,41.36,3808,0
XJR,3803,0,0.00,0,0.00,41.10,3803,0
NFLU,3776,251,38.49,250,37.00,37.86,3776,0
KOCT,3768,0,0.00,0,0.00,30.54,3768,0
ZOCT,3757,0,0.00,1,25.22,25.28,3757,0
TMFS,3755,0,0.00,0,0.00,35.37,3755,0
OMFS,3545,0,0.00,0,0.00,39.58,3402,143
PJUL,3544,0,0.00,0,0.00,41.25,3544,0
PTMC,3525,0,0.00,0,0.00,36.83,3525,0
BJUN,3496,0,0.00,0,0.00,41.65,3196,300
BLDG,3468,0,0.00,0,0.00,25.03,3468,0
XJUN,3451,0,0.00,0,0.00,38.66,3451,0
PMAR,3433,0,0.00,0,0.00,40.22,3433,0
AAPX,3425,51,32.88,51,32.11,32.55,3425,0
BBEM,3334,0,0.00,0,0.00,51.33,3334,0
KRUZ,3330,0,0.00,0,0.00,32.36,3330,0
KJUN,3308,0,0.00,0,0.00,26.95,3308,0
IGLD,3284,0,0.00,0,0.00,18.78,3088,196
KAPR,3270,0,0.00,0,0.00,32.57,3270,0
VFMV,3235,0,0.00,35,120.00,120.47,3235,0
SVAL,3185,0,0.00,0,0.00,32.34,3185,0
TMAT,3163,0,0.00,0,0.00,21.21,2441,722
VFMF,3088,0,0.00,30,130.00,130.35,3088,0
IBHK,3036,0,0.00,0,0.00,25.31,3036,0
OSCV,3029,0,0.00,0,0.00,36.89,3029,0
GOOP,3012,0,0.00,0,0.00,31.72,2725,287
TOLL,2994,0,0.00,32,30.92,31.70,2994,0
BUFF,2917,0,0.00,0,0.00,45.02,2796,121
SMOT,2863,0,0.00,0,0.00,34.43,2863,0
DHDG,2838,0,0.00,0,0.00,30.72,2838,0
FLQL,2700,0,0.00,0,0.00,58.88,2700,0
XSEP,2698,0,0.00,0,0.00,38.94,2698,0
HYXU,2682,0,0.00,0,0.00,47.31,2682,0
FNOV,2676,0,0.00,0,0.00,47.95,2676,0
DRAG,2669,30,21.31,102,21.00,21.21,2669,0
GHTA,2655,0,0.00,0,0.00,28.21,2655,0
KDEC,2615,0,0.00,0,0.00,23.97,2615,0
JUCY,2607,0,0.00,0,0.00,22.79,2607,0
PBTP,2585,0,0.00,0,0.00,25.39,2357,228
ABLG,2555,0,0.00,0,0.00,28.63,2455,100
FBCV,2517,0,0.00,0,0.00,31.52,2517,0
NAPR,2509,0,0.00,0,0.00,50.60,2509,0
TDV,2502,0,0.00,0,0.00,75.50,2502,0
SNOV,2482,0,0.00,0,0.00,23.09,2482,0
YETH,2481,0,0.00,0,0.00,49.99,2462,19
SHAG,2462,0,0.00,0,0.00,47.18,2462,0
PSEP,2409,0,0.00,0,0.00,39.15,2409,0
NULG,2406,0,0.00,0,0.00,86.53,2406,0
OUSA,2382,0,0.00,0,0.00,53.05,2382,0
BDEC,2321,0,0.00,0,0.00,43.12,2321,0
TAIL,2311,0,0.00,0,0.00,11.18,2311,0
BUSA,2287,0,0.00,0,0.00,31.57,2287,0
URAN,2249,0,0.00,2,27.45,28.92,2249,0
TDVI,2242,0,0.00,0,0.00,24.18,2240,2
IGE,2238,0,0.00,0,0.00,42.31,2238,0
VXZ,2198,0,0.00,24,41.38,50.70,2198,0
FJAN,2189,0,0.00,0,0.00,45.94,2189,0
IZRL,2149,0,0.00,0,0.00,22.23,2145,4
QUVU,2130,0,0.00,0,0.00,24.33,2130,0
BBIB,2106,0,0.00,0,0.00,96.63,2106,0
TMFX,2093,0,0.00,0,0.00,19.60,2017,76
USEP,2089,0,0.00,0,0.00,35.28,2089,0
FFEB,2075,0,0.00,0,0.00,49.89,2075,0
IVRA,2073,0,0.00,0,0.00,15.35,2021,52
HAUS,2070,0,0.00,0,0.00,17.91,2070,0
EFAD,2005,0,0.00,0,0.00,37.04,2005,0
DOGG,1977,0,0.00,0,0.00,18.97,1977,0
EALT,1977,0,0.00,0,0.00,32.36,1977,0
NOCT,1922,0,0.00,0,0.00,51.44,1922,0
HOCT,1902,0,0.00,0,0.00,23.94,1902,0
RODE,1901,0,0.00,0,0.00,27.60,1901,0
BAUG,1886,0,0.00,0,0.00,43.77,1886,0
EAOM,1886,0,0.00,0,0.00,27.47,1886,0
ABOT,1885,0,0.00,0,0.00,36.53,1744,141
XDSQ,1868,0,0.00,0,0.00,36.82,1868,0
BNOV,1839,0,0.00,0,0.00,39.33,1839,0
XFEB,1837,0,0.00,0,0.00,32.69,1837,0
POCT,1832,0,0.00,0,0.00,39.65,1832,0
DMAY,1806,0,0.00,0,0.00,40.85,1806,0
XVOL,1802,0,0.00,0,0.00,21.46,1802,0
FHDG,1801,0,0.00,0,0.00,30.80,1801,0
MDLV,1800,0,0.00,0,0.00,25.62,1800,0
OCTM,1800,0,0.00,0,0.00,30.56,1800,0
ZALT,1792,0,0.00,0,0.00,29.91,1792,0
LEAD,1774,0,0.00,0,0.00,66.65,1774,0
GHYG,1766,0,0.00,0,0.00,44.19,1766,0
FPRO,1761,0,0.00,0,0.00,22.11,1761,0
HYHG,1760,0,0.00,0,0.00,65.68,1760,0
FAUG,1754,0,0.00,0,0.00,46.65,1754,0
ZNOV,1700,0,0.00,0,0.00,25.16,1700,0
BKGI,1688,0,0.00,0,0.00,30.24,1688,0
TBJL,1621,0,0.00,0,0.00,19.65,1621,0
SEPM,1590,0,0.00,0,0.00,29.85,1590,0
QMNV,1582,0,0.00,0,0.00,20.31,1582,0
PBP,1559,0,0.00,0,0.00,23.59,1559,0
QPFF,1531,0,0.00,0,0.00,35.98,1531,0
VSDM,1522,0,0.00,0,0.00,74.81,1522,0
QMAR,1505,0,0.00,0,0.00,29.86,1505,0
XJAN,1499,0,0.00,0,0.00,33.65,1499,0
SEIM,1456,0,0.00,0,0.00,38.86,1456,0
DNOV,1450,0,0.00,0,0.00,42.94,1450,0
RTAI,1436,0,0.00,0,0.00,21.10,1436,0
SEIV,1405,0,0.00,0,0.00,33.18,1405,0
QLC,1394,0,0.00,0,0.00,66.64,1394,0
GJUN,1377,0,0.00,0,0.00,36.11,1377,0
NDOW,1377,0,0.00,0,0.00,24.29,1377,0
NUMG,1361,0,0.00,0,0.00,47.76,1354,7
XBJA,1357,0,0.00,0,0.00,28.83,1104,253
UAUG,1311,0,0.00,0,0.00,35.60,1311,0
GMOM,1291,0,0.00,0,0.00,28.76,1291,0
XUSP,1287,0,0.00,0,0.00,40.48,1287,0
ADME,1280,0,0.00,0,0.00,46.92,1280,0
XMAY,1257,0,0.00,0,0.00,31.58,1257,0
QSIG,1252,0,0.00,0,0.00,48.05,1252,0
BAMY,1243,0,0.00,0,0.00,26.53,1243,0
USMF,1235,0,0.00,0,0.00,49.66,1179,56
FDEV,1222,0,0.00,0,0.00,27.34,1222,0
MSMR,1221,0,0.00,0,0.00,30.25,1221,0
BRLN,1215,50,52.52,0,0.00,52.49,1215,0
ENOR,1203,0,0.00,0,0.00,22.39,1203,0
QETH,1202,5200,33.50,3000,33.42,33.94,1202,0
GEMD,1174,0,0.00,0,0.00,40.22,1174,0
TUSI,1118,0,0.00,0,0.00,25.30,1118,0
FFSM,1117,0,0.00,0,0.00,26.84,1117,0
BUFY,1103,0,0.00,0,0.00,18.80,1103,0
XTOC,1100,0,0.00,0,0.00,29.54,1100,0
HFGO,1081,0,0.00,0,0.00,23.91,1081,0
LKOR,1076,0,0.00,0,0.00,42.12,1076,0
GVAL,1033,0,0.00,0,0.00,20.92,1033,0
NUEM,1032,0,0.00,0,0.00,29.02,1032,0
BMAY,1018,0,0.00,0,0.00,40.38,1018,0
BJAN,1007,0,0.00,0,0.00,47.95,1007,0
PSCQ,1005,0,0.00,0,0.00,26.59,1005,0
XDAT,1003,0,0.00,0,0.00,25.54,1003,0
RMIF,1000,0,0.00,0,0.00,25.30,1000,0
SHEH,1000,0,0.00,0,0.00,46.80,1000,0
XIDE,981,0,0.00,0,0.00,30.16,981,0
DAPR,965,0,0.00,0,0.00,37.27,965,0
NULC,945,0,0.00,0,0.00,45.64,945,0
FBUF,935,0,0.00,0,0.00,27.49,935,0
QHY,932,0,0.00,0,0.00,45.11,932,0
INTL,926,0,0.00,0,0.00,22.17,926,0
KJUL,925,0,0.00,0,0.00,29.42,925,0
GPOW,916,0,0.00,0,0.00,52.70,916,0
JEMA,915,0,0.00,0,0.00,37.49,904,11
NFLP,914,0,0.00,0,0.00,36.33,914,0
FOCT,907,0,0.00,0,0.00,42.82,722,185
MOTI,906,0,0.00,0,0.00,30.26,906,0
IMFL,902,0,0.00,0,0.00,23.54,902,0
EAOK,901,1,25.64,1,21.97,25.57,901,0
NDEC,900,0,0.00,0,0.00,24.56,900,0
RYSE,867,0,0.00,0,0.00,24.65,867,0
FAPR,847,0,0.00,0,0.00,41.35,847,0
EWUS,844,0,0.00,0,0.00,34.54,844,0
ARKZ,834,0,0.00,0,0.00,37.37,834,0
IPDP,826,1,22.00,0,0.00,19.14,826,0
XEMD,806,0,0.00,0,0.00,41.75,806,0
ADFI,805,0,0.00,0,0.00,8.43,705,100
MGRO,803,0,0.00,0,0.00,30.73,803,0
PBFR,803,0,0.00,0,0.00,26.54,803,0
XBAP,800,0,0.00,0,0.00,34.12,800,0
AAPY,799,0,0.00,5,27.34,27.35,798,1
NAUG,797,0,0.00,0,0.00,25.84,797,0
CPSL,792,0,0.00,0,0.00,25.57,792,0
SHDG,779,0,0.00,0,0.00,29.23,779,0
BBLB,764,0,0.00,0,0.00,83.56,764,0
QCON,763,0,0.00,0,0.00,45.58,763,0
STOT,752,0,0.00,0,0.00,46.81,752,0
FJUN,751,0,0.00,0,0.00,51.61,751,0
VAMO,751,0,0.00,0,0.00,29.70,751,0
PSFO,750,0,0.00,0,0.00,28.89,750,0
GAPR,736,0,0.00,0,0.00,37.50,736,0
BUFG,732,0,0.00,0,0.00,24.50,732,0
FMAR,732,0,0.00,0,0.00,43.36,732,0
FLQS,711,0,0.00,0,0.00,41.40,711,0
DUBS,701,0,0.00,0,0.00,32.64,701,0
JUNM,700,0,0.00,0,0.00,31.79,700,0
UPSD,696,0,0.00,0,0.00,24.21,696,0
OBND,695,0,0.00,0,0.00,25.71,695,0
QJUN,688,0,0.00,0,0.00,28.18,688,0
EDEN,686,0,0.00,0,0.00,106.51,686,0
SFEB,672,0,0.00,0,0.00,21.51,672,0
PSDM,664,0,0.00,0,0.00,50.74,664,0
NVBU,662,0,0.00,0,0.00,25.57,662,0
HEEM,661,0,0.00,0,0.00,26.99,661,0
TYLD,658,0,0.00,0,0.00,25.23,658,0
NJUL,655,0,0.00,0,0.00,63.13,655,0
NOVM,649,0,0.00,0,0.00,30.64,513,136
APOC,646,0,0.00,0,0.00,25.51,646,0
PAWZ,639,0,0.00,0,0.00,54.48,615,24
GNOV,633,0,0.00,0,0.00,34.98,633,0
RDFI,624,0,0.00,0,0.00,23.51,624,0
BJUL,622,0,0.00,0,0.00,44.73,522,100
MVFG,621,0,0.00,0,0.00,26.17,621,0
ESG,619,0,0.00,0,0.00,138.26,619,0
MSFY,618,0,0.00,0,0.00,25.50,616,2
EAOA,617,0,0.00,0,0.00,35.85,617,0
BAPR,615,0,0.00,0,0.00,44.42,615,0
JANZ,613,0,0.00,1,26.01,34.51,613,0
FYEE,612,0,0.00,0,0.00,26.67,612,0
PSCJ,611,0,0.00,0,0.00,26.77,611,0
PIEQ,610,0,0.00,0,0.00,24.27,610,0
QIG,604,0,0.00,0,0.00,43.96,604,0
DJUL,602,0,0.00,0,0.00,42.13,602,0
VEGN,602,0,0.00,0,0.00,54.05,602,0
IEDI,601,0,0.00,1,51.97,53.61,601,0
MILK,600,0,0.00,0,0.00,24.54,600,0
PSFJ,600,0,0.00,0,0.00,29.32,600,0
SAUG,590,0,0.00,0,0.00,23.57,490,100
PJUN,589,0,0.00,0,0.00,37.58,589,0
BLKC,588,0,0.00,0,0.00,22.63,588,0
RSBY,578,0,0.00,0,0.00,17.95,578,0
GFEB,577,0,0.00,0,0.00,37.41,577,0
GDMN,576,0,0.00,0,0.00,28.30,576,0
OGIG,567,0,0.00,0,0.00,46.23,512,55
IVVW,564,0,0.00,44,48.74,50.35,564,0
JAJL,563,0,0.00,0,0.00,27.27,563,0
ATMP,560,0,0.00,0,0.00,28.23,560,0
PEX,554,0,0.00,0,0.00,27.83,554,0
ROMO,554,0,0.00,0,0.00,31.73,554,0
CNAV,551,0,0.00,0,0.00,26.63,551,0
DSEP,540,0,0.00,0,0.00,40.67,540,0
MVFD,539,0,0.00,0,0.00,25.95,539,0
JCPI,532,0,0.00,0,0.00,46.92,532,0
QVOY,525,0,0.00,0,0.00,25.42,525,0
MOTG,520,0,0.00,0,0.00,36.21,520,0
BCHP,513,0,0.00,0,0.00,33.96,513,0
TRTY,511,0,0.00,0,0.00,25.29,511,0
FHEQ,509,0,0.00,0,0.00,27.60,497,12
QBER,503,0,0.00,0,0.00,24.73,503,0
SEIQ,501,0,0.00,0,0.00,35.14,501,0
NSEP,500,0,0.00,0,0.00,25.77,500,0
PBDE,500,0,0.00,0,0.00,26.40,500,0
UXOC,500,0,0.00,0,0.00,30.59,500,0
YSEP,500,0,0.00,0,0.00,21.77,500,0
ARKY,498,0,0.00,0,0.00,37.30,498,0
IWMW,495,0,0.00,0,0.00,44.00,495,0
BUFB,483,0,0.00,0,0.00,32.40,483,0
XDQQ,481,0,0.00,0,0.00,34.71,481,0
AFIF,480,0,0.00,0,0.00,9.14,480,0
MAGA,471,0,0.00,4,46.50,47.47,471,0
ISVL,469,0,0.00,0,0.00,34.33,469,0
SMI,457,0,0.00,0,0.00,45.98,457,0
YMAR,454,0,0.00,0,0.00,22.83,454,0
OVL,453,0,0.00,0,0.00,46.87,443,10
AUGM,450,0,0.00,0,0.00,31.88,450,0
HCRB,445,0,0.00,0,0.00,34.76,445,0
EFNL,442,0,0.00,0,0.00,32.49,442,0
GJAN,437,0,0.00,0,0.00,38.69,437,0
MYLD,437,0,0.00,0,0.00,25.91,437,0
YJUN,427,0,0.00,0,0.00,21.65,427,0
FDND,425,0,0.00,0,0.00,22.59,425,0
UNOV,424,0,0.00,0,0.00,34.67,424,0
FFLV,418,0,0.00,0,0.00,21.38,418,0
VWID,417,0,0.00,0,0.00,26.61,417,0
XBJL,413,0,0.00,0,0.00,34.19,413,0
DOCT,412,0,0.00,0,0.00,39.37,412,0
LQDI,406,0,0.00,0,0.00,25.58,406,0
XMAR,400,0,0.00,0,0.00,36.20,400,0
DURA,393,0,0.00,0,0.00,32.48,393,0
DECZ,392,0,0.00,0,0.00,37.23,392,0
DAUG,381,0,0.00,0,0.00,39.80,381,0
MSTB,372,0,0.00,0,0.00,34.32,372,0
XIJN,368,0,0.00,0,0.00,30.81,368,0
XISE,366,0,0.00,0,0.00,30.26,366,0
EMTL,359,0,0.00,0,0.00,42.10,359,0
MBBB,358,0,0.00,0,0.00,21.19,358,0
YDEC,355,0,0.00,0,0.00,22.60,355,0
FDHT,351,46,21.70,44,16.70,19.66,351,0
FOWF,350,0,0.00,0,0.00,24.32,350,0
TMDV,347,0,0.00,0,0.00,46.59,347,0
SMAY,346,0,0.00,0,0.00,24.82,346,0
BMAR,333,0,0.00,0,0.00,46.27,333,0
NURE,329,0,0.00,0,0.00,31.54,329,0
FIBR,324,0,0.00,0,0.00,87.06,324,0
EUDV,323,0,0.00,0,0.00,46.67,323,0
HSRT,318,0,0.00,0,0.00,39.27,318,0
UOCT,318,0,0.00,0,0.00,35.39,318,0
CMCI,313,0,0.00,0,0.00,24.57,313,0
QTJL,304,0,0.00,0,0.00,32.79,304,0
AESR,303,0,0.00,0,0.00,17.43,303,0
LIAC,300,0,0.00,0,0.00,16.26,300,0
OVM,300,0,0.00,0,0.00,21.76,300,0
PWS,300,0,0.00,0,0.00,30.42,300,0
QSPT,300,0,0.00,0,0.00,27.80,300,0
XOCT,300,0,0.00,0,0.00,34.36,300,0
EMDV,295,0,0.00,0,0.00,43.13,295,0
UJUL,295,0,0.00,0,0.00,34.61,295,0
GMAY,275,0,0.00,0,0.00,37.00,275,0
GJUL,269,0,0.00,0,0.00,36.78,269,0
GMAR,269,0,0.00,0,0.00,37.54,269,0
QMAG,269,0,0.00,0,0.00,20.98,269,0
UAPR,269,0,0.00,0,0.00,30.93,269,0
BSEP,268,0,0.00,0,0.00,43.02,268,0
GOCT,257,0,0.00,0,0.00,35.12,257,0
GAUG,253,0,0.00,0,0.00,35.37,253,0
NUDV,253,0,0.00,0,0.00,27.51,253,0
MFUL,249,0,0.00,0,0.00,21.46,249,0
RPHS,246,0,0.00,0,0.00,10.21,246,0
MARZ,244,0,0.00,0,0.00,31.57,244,0
PSMO,244,0,0.00,0,0.00,28.33,244,0
LCF,238,0,0.00,0,0.00,36.42,238,0
TILT,238,0,0.00,0,0.00,216.44,238,0
MINN,230,0,0.00,0,0.00,21.97,230,0
ARCM,220,0,0.00,0,0.00,100.11,220,0
ARKC,219,0,0.00,0,0.00,38.00,219,0
ABFL,217,0,0.00,0,0.00,66.72,217,0
BAMO,217,0,0.00,0,0.00,30.39,217,0
PFEB,217,120,36.81,0,0.00,36.86,217,0
BFEB,215,0,0.00,0,0.00,43.13,215,0
JULQ,208,0,0.00,0,0.00,25.17,208,0
OEUR,208,0,0.00,0,0.00,27.53,208,0
HIYS,205,0,0.00,0,0.00,25.40,205,0
DECM,204,0,0.00,0,0.00,30.77,204,0
HJUL,202,0,0.00,0,0.00,24.06,202,0
XBOC,201,0,0.00,0,0.00,30.26,201,0
BUFT,200,0,0.00,0,0.00,22.49,200,0
FAIL,200,0,0.00,0,0.00,16.21,200,0
LIAB,200,0,0.00,0,0.00,15.44,200,0
QMMY,200,0,0.00,0,0.00,21.68,200,0
STBF,183,0,0.00,0,0.00,25.07,183,0
WUGI,182,57,80.00,0,0.00,73.32,182,0
HSUN,175,0,0.00,0,0.00,34.85,175,0
IVVB,174,0,0.00,0,0.00,30.68,173,1
LJAN,172,0,0.00,0,0.00,24.52,172,0
GDMA,161,0,0.00,0,0.00,31.79,161,0
ZJUL,156,0,0.00,0,0.00,27.12,156,0
EAOR,155,0,0.00,0,0.00,31.42,155,0
SNAV,152,0,0.00,0,0.00,30.30,152,0
BINV,151,0,0.00,0,0.00,29.71,151,0
TRSY,151,0,0.00,0,0.00,30.03,151,0
FDVL,149,0,0.00,0,0.00,10.21,149,0
COPA,142,0,0.00,0,0.00,22.54,142,0
RVRB,139,0,0.00,0,0.00,30.61,139,0
BAMB,135,0,0.00,0,0.00,25.57,135,0
GROZ,135,0,0.00,0,0.00,25.22,135,0
GSEP,131,0,0.00,0,0.00,35.13,131,0
EVLU,128,0,0.00,0,0.00,24.44,128,0
APRD,126,0,0.00,0,0.00,25.14,126,0
TLTP,121,0,0.00,0,0.00,23.72,121,0
DFND,120,0,0.00,0,0.00,41.98,120,0
FFDI,120,0,0.00,0,0.00,24.41,120,0
KAUG,120,0,0.00,0,0.00,25.14,120,0
FDGR,119,0,0.00,0,0.00,14.29,119,0
GHMS,119,0,0.00,0,0.00,25.24,119,0
BAMA,117,0,0.00,0,0.00,30.67,117,0
RULE,117,0,0.00,0,0.00,22.03,117,0
BAMD,115,0,0.00,0,0.00,31.52,115,0
QCOC,111,0,0.00,0,0.00,20.18,111,0
LFAE,110,0,0.00,0,0.00,12.13,110,0
OVS,110,0,0.00,0,0.00,34.92,110,0
AQLT,107,0,0.00,0,0.00,24.05,107,0
LIMI,106,0,0.00,0,0.00,24.75,106,0
SEPZ,106,0,0.00,0,0.00,38.20,106,0
ABLD,102,0,0.00,0,0.00,27.91,102,0
FCTR,102,0,0.00,0,0.00,32.92,102,0
PSFD,102,0,0.00,0,0.00,33.22,102,0
DJAN,101,0,0.00,0,0.00,39.10,101,0
FDTB,101,0,0.00,0,0.00,9.35,101,0
MSTQ,101,0,0.00,0,0.00,34.22,101,0
EGUS,100,0,0.00,0,0.00,44.75,100,0
EVUS,100,0,0.00,0,0.00,28.78,100,0
HJAN,100,0,0.00,0,0.00,24.56,100,0
JULH,100,0,0.00,0,0.00,25.31,100,0
JULJ,100,0,0.00,0,0.00,25.20,100,0
KSEP,100,0,0.00,0,0.00,25.65,100,0
LIAK,100,0,0.00,0,0.00,20.01,100,0
MBND,100,0,0.00,0,0.00,27.43,100,0
MRGR,100,0,0.00,3,33.33,41.00,100,0
UMAR,100,0,0.00,0,0.00,35.71,100,0
AAPR,99,0,0.00,0,0.00,26.40,99,0
BEMB,96,0,0.00,0,0.00,51.69,96,0
EQLT,95,0,0.00,0,0.00,23.47,95,0
FEBZ,93,0,0.00,0,0.00,34.61,93,0
IQM,91,0,0.00,0,0.00,67.53,91,0
MFUT,89,0,0.00,0,0.00,16.62,89,0
JULZ,86,0,0.00,0,0.00,41.93,86,0
SNPG,83,0,0.00,0,0.00,45.57,75,8
OVF,79,0,0.00,0,0.00,23.52,79,0
PSH,77,0,0.00,0,0.00,50.08,77,0
FSEP,69,0,0.00,0,0.00,45.77,69,0
AJAN,68,0,0.00,0,0.00,26.23,68,0
XIMR,66,0,0.00,0,0.00,31.16,66,0
SNPV,64,0,0.00,0,0.00,31.17,64,0
XDOC,63,0,0.00,0,0.00,30.37,63,0
ESGG,60,0,0.00,0,0.00,168.90,60,0
UJUN,60,0,0.00,0,0.00,33.89,60,0
OCTH,59,0,0.00,0,0.00,24.26,59,0
XAUG,56,0,0.00,0,0.00,34.25,56,0
JAND,55,0,0.00,0,0.00,25.10,55,0
HEAT,51,0,0.00,0,0.00,25.55,51,0
WBAT,51,0,0.00,0,0.00,26.88,51,0
XJUL,51,0,0.00,0,0.00,35.50,51,0
AUGU,50,0,0.00,0,0.00,26.36,50,0
GSEE,42,0,0.00,0,0.00,43.89,42,0
HELX,42,0,0.00,0,0.00,28.75,42,0
GUNZ,40,0,0.00,0,0.00,27.21,40,0
CSM,37,9,78.00,0,0.00,66.49,37,0
BAMU,36,0,0.00,0,0.00,25.13,36,0
OVLH,35,0,0.00,0,0.00,34.26,35,0
PUTD,32,0,0.00,2,20.72,20.85,32,0
BAMV,31,0,0.00,0,0.00,30.38,31,0
SCLZ,31,0,0.00,0,0.00,53.16,31,0
WHTX,31,0,0.00,0,0.00,15.08,31,0
CVAR,27,0,0.00,0,0.00,25.00,27,0
BOCT,25,0,0.00,0,0.00,43.30,25,0
LOCT,25,0,0.00,0,0.00,23.87,25,0
IVVM,24,0,0.00,0,0.00,30.78,4,20
MIG,24,0,0.00,0,0.00,21.14,24,0
PIT,21,0,0.00,0,0.00,47.22,21,0
TGLR,21,0,0.00,0,0.00,29.74,21,0
ARKA,19,0,0.00,1,59.80,61.84,19,0
TJUL,18,0,0.00,0,0.00,27.81,18,0
XDAP,17,0,0.00,0,0.00,35.56,17,0
EUAD,15,0,0.00,0,0.00,24.69,15,0
CORX,14,0,0.00,0,0.00,16.62,14,0
NXTV,13,0,0.00,0,0.00,25.26,13,0
GCLN,12,2,36.00,0,0.00,35.47,12,0
AJUL,10,0,0.00,0,0.00,27.07,10,0
BHYB,10,0,0.00,0,0.00,53.47,10,0
KNOW,7,0,0.00,0,0.00,10.84,7,0
VMAX,7,0,0.00,0,0.00,47.68,7,0
TLTI,6,0,0.00,0,0.00,47.11,6,0
ACSI,5,0,0.00,0,0.00,61.08,5,0
DMAR,5,0,0.00,0,0.00,38.19,5,0
FUNL,5,0,0.00,0,0.00,41.70,5,0
QBUL,5,0,0.00,0,0.00,25.27,5,0
ROIS,5,0,0.00,0,0.00,48.37,5,0
TDEC,4,0,0.00,0,0.00,19.87,4,0
ISDB,3,0,0.00,0,0.00,24.86,3,0
NXTI,3,0,0.00,0,0.00,28.26,3,0
AUGZ,2,0,0.00,0,0.00,38.83,2,0
BBSB,2,0,0.00,0,0.00,98.37,2,0
BUYZ,2,0,0.00,0,0.00,37.21,2,0
DJUN,2,0,0.00,0,0.00,43.34,2,0
DWCR,2,0,0.00,0,0.00,28.11,2,0
FFEM,2,0,0.00,0,0.00,24.28,2,0
LBO,2,0,0.00,0,0.00,33.14,2,0
OCTQ,2,0,0.00,0,0.00,24.07,2,0
PBL,2,0,0.00,0,0.00,28.44,2,0
APRZ,1,0,0.00,0,0.00,34.37,1,0
DWAT,1,0,0.00,0,0.00,11.37,1,0
FDCE,1,0,0.00,0,0.00,12.78,1,0
IDVZ,1,0,0.00,0,0.00,25.66,1,0
JUNZ,1,0,0.00,0,0.00,29.69,1,0
LIAX,1,0,0.00,0,0.00,26.31,1,0
MAYZ,1,0,0.00,0,0.00,30.24,1,0
MOTE,1,0,0.00,0,0.00,28.26,1,0
NOVZ,1,0,0.00,0,0.00,40.25,1,0
PJBF,1,0,0.00,0,0.00,60.61,1,0
PSFM,1,0,0.00,0,0.00,29.29,1,0
PTEU,1,0,0.00,0,0.00,24.00,1,0
RSBA,1,0,0.00,0,0.00,20.03,1,0
SNPD,1,0,0.00,0,0.00,26.05,1,0
SPCZ,1,0,0.00,0,0.00,25.98,1,0
SPMV,1,0,0.00,0,0.00,46.00,1,0
ABHY,0,0,0.00,0,0.00,0.00,0,0
APRH,0,0,0.00,0,0.00,0.00,0,0
APRJ,0,0,0.00,0,0.00,0.00,0,0
APRP,0,0,0.00,0,0.00,0.00,0,0
APRQ,0,0,0.00,0,0.00,0.00,0,0
ARLU,0,0,0.00,0,0.00,0.00,0,0
AUGP,0,0,0.00,0,0.00,0.00,0,0
AZNH,0,0,0.00,0,0.00,0.00,0,0
BSMC,0,0,0.00,0,0.00,0.00,0,0
BUFP,0,0,0.00,0,0.00,0.00,0,0
BWTG,0,0,0.00,0,0.00,0.00,0,0
DECP,0,0,0.00,0,0.00,0.00,0,0
ESGX,0,0,0.00,0,0.00,0.00,0,0
FEBP,0,0,0.00,0,0.00,0.00,0,0
FFGX,0,0,0.00,0,0.00,0.00,0,0
FLDZ,0,0,0.00,0,0.00,0.00,0,0
FPAS,0,0,0.00,0,0.00,0.00,0,0
GLBL,0,0,0.00,0,0.00,0.00,0,0
GSID,0,0,0.00,0,0.00,0.00,0,0
HAPR,0,0,0.00,0,0.00,0.00,0,0
HSBH,0,0,0.00,0,0.00,0.00,0,0
HYKE,0,0,0.00,0,0.00,0.00,0,0
IMSI,0,0,0.00,0,0.00,0.00,0,0
IPAV,0,0,0.00,0,0.00,0.00,0,0
IPPP,0,0,0.00,0,0.00,0.00,0,0
JANP,0,0,0.00,0,0.00,0.00,0,0
JNEU,0,0,0.00,0,0.00,0.00,0,0
JULD,0,0,0.00,0,0.00,0.00,0,0
JULM,0,0,0.00,0,0.00,0.00,0,0
JULP,0,0,0.00,0,0.00,0.00,0,0
JULU,0,0,0.00,0,0.00,0.00,0,0
JUNP,0,0,0.00,0,0.00,0.00,0,0
LAPR,0,0,0.00,0,0.00,0.00,0,0
LFAF,0,0,0.00,0,0.00,0.00,0,0
LFAI,0,0,0.00,0,0.00,0.00,0,0
LFAJ,0,0,0.00,0,0.00,0.00,0,0
LFAK,0,0,0.00,0,0.00,0.00,0,0
LFAL,0,0,0.00,0,0.00,0.00,0,0
LFAN,0,0,0.00,0,0.00,0.00,0,0
LFAO,0,0,0.00,0,0.00,0.00,0,0
LFAQ,0,0,0.00,0,0.00,0.00,0,0
LFAR,0,0,0.00,0,0.00,0.00,0,0
LFAU,0,0,0.00,0,0.00,0.00,0,0
LFAV,0,0,0.00,0,0.00,0.00,0,0
LFAW,0,0,0.00,0,0.00,0.00,0,0
LFAX,0,0,0.00,0,0.00,0.00,0,0
LFAZ,0,0,0.00,0,0.00,0.00,0,0
LFBB,0,0,0.00,0,0.00,0.00,0,0
LFDR,0,0,0.00,1,19.60,0.00,0,0
LIAE,0,0,0.00,0,0.00,0.00,0,0
LIAF,0,0,0.00,0,0.00,0.00,0,0
LIAG,0,0,0.00,0,0.00,0.00,0,0
LIAJ,0,0,0.00,0,0.00,0.00,0,0
LIAM,0,0,0.00,0,0.00,0.00,0,0
LIAO,0,0,0.00,0,0.00,0.00,0,0
LIAP,0,0,0.00,0,0.00,0.00,0,0
LIAQ,0,0,0.00,0,0.00,0.00,0,0
LIAT,0,0,0.00,0,0.00,0.00,0,0
LIAU,0,0,0.00,0,0.00,0.00,0,0
LIAV,0,0,0.00,0,0.00,0.00,0,0
LIAW,0,0,0.00,0,0.00,0.00,0,0
LJUL,0,0,0.00,0,0.00,0.00,0,0
LYLD,0,0,0.00,0,0.00,0.00,0,0
MAYP,0,0,0.00,0,0.00,0.00,0,0
MAYU,0,0,0.00,0,0.00,0.00,0,0
MBNE,0,0,0.00,0,0.00,0.00,0,0
MDEV,0,0,0.00,200,20.00,0.00,0,0
MRCP,0,0,0.00,0,0.00,0.00,0,0
MVAL,0,0,0.00,0,0.00,0.00,0,0
NJUN,0,0,0.00,0,0.00,0.00,0,0
NNOV,0,0,0.00,0,0.00,0.00,0,0
NOVP,0,0,0.00,0,0.00,0.00,0,0
OCTD,0,0,0.00,0,0.00,0.00,0,0
OCTJ,0,0,0.00,0,0.00,0.00,0,0
OCTP,0,0,0.00,0,0.00,0.00,0,0
OCTU,0,0,0.00,0,0.00,0.00,0,0
OCTZ,0,0,0.00,0,0.00,0.00,0,0
PBAP,0,0,0.00,0,0.00,0.00,0,0
PBAU,0,0,0.00,0,0.00,0.00,0,0
PBFB,0,0,0.00,0,0.00,0.00,0,0
PBJA,0,0,0.00,0,0.00,0.00,0,0
PBJL,0,0,0.00,0,0.00,0.00,0,0
PBJN,0,0,0.00,0,0.00,0.00,0,0
PBMR,0,0,0.00,0,0.00,0.00,0,0
PBMY,0,0,0.00,0,0.00,0.00,0,0
PBNV,0,0,0.00,0,0.00,0.00,0,0
PBOC,0,0,0.00,0,0.00,0.00,0,0
PBSE,0,0,0.00,0,0.00,0.00,0,0
PJFM,0,0,0.00,0,0.00,0.00,0,0
PSCW,0,0,0.00,0,0.00,0.00,0,0
PSCX,0,0,0.00,0,0.00,0.00,0,0
PSMD,0,0,0.00,0,0.00,0.00,0,0
PSMJ,0,0,0.00,0,0.00,0.00,0,0
PSMR,0,0,0.00,0,0.00,0.00,0,0
QCAP,0,0,0.00,0,0.00,0.00,0,0
QCJL,0,0,0.00,0,0.00,0.00,0,0
QTAP,0,0,0.00,0,0.00,0.00,0,0
QTJA,0,0,0.00,0,0.00,0.00,0,0
QTOC,0,0,0.00,0,0.00,0.00,0,0
RTRE,0,0,0.00,0,0.00,0.00,0,0
SELV,0,0,0.00,0,0.00,0.00,0,0
SEPP,0,0,0.00,0,0.00,0.00,0,0
SEPU,0,0,0.00,0,0.00,0.00,0,0
SPIN,0,0,0.00,0,0.00,0.00,0,0
SQMX,0,0,0.00,0,0.00,0.00,0,0
TFJL,0,0,0.00,0,0.00,0.00,0,0
TSEP,0,0,0.00,0,0.00,0.00,0,0
UFEB,0,0,0.00,0,0.00,0.00,0,0
UMAY,0,0,0.00,0,0.00,0.00,0,0
WDNA,0,0,0.00,0,0.00,0.00,0,0
WLDR,0,0,0.00,0,0.00,0.00,0,0
XAPR,0,0,0.00,0,0.00,0.00,0,0
XDJA,0,0,0.00,0,0.00,0.00,0,0
XDJL,0,0,0.00,0,0.00,0.00,0,0
XNOV,0,0,0.00,0,0.00,0.00,0,0
XTAP,0,0,0.00,0,0.00,0.00,0,0
XTJA,0,0,0.00,0,0.00,0.00,0,0
XTJL,0,0,0.00,0,0.00,0.00,0,0
ZAUG,0,0,0.00,0,0.00,0.00,0,0